7 10
##########
#........#
####..####
#..#..#..#
####..#..#
#.....#..#
##########
