14 34
##################################
#..##.#...#...#.............#....#
#..##.#.#.#.#.###########.######.#
#..#..#.#.#.#....................#
#..##...#...#.##################.#
#..#############...#...#...#...###
#..##............#...#...#...#...#
#..##.############.###############
#..##.#..........#...............#
#..##.############.###############
#..##..............#.............#
#..##.############.#.............#
#.....#..........#...............#
##################################
